# Level 5: Ultimate Rock Challenge - Maximum scattered rocks
# W = Wall/Earth, . = Empty space, R = Rock, P = Player start, M = Monster, D = Dragon
........................................
........................................
........................................
WWWWWWWWWWWWWWWWWPWWWWWWWWWWWWWWWWWWWWWW
WWWWWWWWWWWWWWWWW.WWWWWWWWWWWWWWWWWWWWWW
WWWWWWWWWWWWWWWWW.WWWWWWWWWWWWWWWWWWWWWW
WWWWWWWWWWWWWWWWW.WWWWWWWWWWWWWWWWWWWWWW
WWWR....R....R...........R....R....RWWW
WWWR.DD.R.MM.R.WWWWWWWWW.R.DD.R.MM.RWWW
WWWR....R....R.WWWWWWWWW.R....R....RWWW
WWWWWWWWWWWWWWW.WWWWWWWWW.WWWWWWWWWWWWWW
WWWWWWWWRWWWWWW.WWWWWWWWW.WWWWWRWWWWWWWW
WWWWWWWWWWWWWWW.WWWWWWWWW.WWWWWWWWWWWWWW
WWWWWWWWWWWWRWW.WWRWWWWWW.WWRWWWWWWWWWWW
WWWWWWWWWWWWWWW.WWWWWWWWW.WWWWWWWWWWWWWW
WWWWWWWWWWWWWWW.WWWWWWWWW.WWWWWWWWWWWWWW
WWWWWWWWRWWWWWW.WWWWWWWWW.WWWWWRWWWWWWWW
WWWWWWWWWWWWWWW.WWWWWWWWW.WWWWWWWWWWWWWW
WWWWWWWWWWWWWWW.WWWWWWWWW.WWWWWWWWWWWWWW
WWWR....R....R.WWWWWWWWW.R....R....RWWW
WWWR.MD.R.DM.R...........R.MD.R.DM.RWWW
WWWR....R....R.WWWWWWWWW.R....R....RWWW
WWWWWWWWWWWWWWW.WWWWWWWWW.WWWWWWWWWWWWWW
WWWWWWWWWWWWWWWWWWWWWWWWWWWWWWWWWWWWWWWW
WWWWWWWWWWWWWWWWWWWWWWWWWWWWWWWWWWWWWWWW
WWWWWWWWWWWWWWWWWWWWWWWWWWWWWWWWWWWWWWWW
WWWWWWWWWWWWWWWWWWWWWWWWWWWWWWWWWWWWWWWW
WWWWWWWWWWWWWWWWWWWWWWWWWWWWWWWWWWWWWWWW
WWWWWWWWWWWWWWWWWWWWWWWWWWWWWWWWWWWWWWWW
WWWWWWWWWWWWWWWWWWWWWWWWWWWWWWWWWWWWWWWW
WWWWWWWWWWWWWWWWWWWWWWWWWWWWWWWWWWWWWWWW
