########################################
########################################
########################################
####################P###################
WWWWWWWWWWWWWWWWWWW.WWWWWWWWWWWWWWWWWWW
WWWWWWWWWWWWWWWWWWW.WWWWWWWWWWWWWWWWWWW
WWWWWWWWWWWWWWWWWWW.WWWWWWWWWWWWWWWWWWW
WWWWWWWWWWWWWRRRRWW.WWWWWWWWWWWWWWWWWWW
WWWWWWWWWWWWWWWWWWW.WWWWWWWWWWWWWWWWWWW
WWWWWWWWWWWWWWWWWWW.WWWWWWWWWWWWWWWWWWW
WWWWWWWWWWWWWWWWWWW.WWWWWWWWWWWWWWWWWWW
WWW...........WWWWW.WWWWWWWWWWWWWWWWWWW
WWWWWWWWWWWWWWWWWWW.WWWWWWWWWWWWWWWWWWW
WWWWWWWWWWWWWWWWWWW.WWWWWWWWWWWWWWWWWWW
.....................M.................
WWWWWWWWWWWWWWWWWWWWWWWWWWWWWWWWWWWWWWW
WWWWWWWWWWWWWWWWWWWWWWWWWWWWWWWWWWWWWWW
WWWWWWWWWWWWWWWWWWWWWWWWWWWWWWWWWWWWWWW
WWWWWWWWWWWWWWWWWWWWWWWWWWWWWWWWWWWWWWW
...............D.M......................
WWWWWWWWWWWWWWWWWWWWWWWWWWWWWWWWWWWWWWW
WWWWWWWWWWWWWWWWWWWWWWWWWWWWWWWWWWWWWWW
WWWWWWWWWWWWWWWWWWWWWWWWWWWWWWWWWWWWWWW
WWWWWWWWWWWWWWWWWWWWWWWWWWWWWWWWWWWWWWW
