# Level 3: Heavy Rock Field - Many scattered rocks throughout
# W = Wall/Earth, . = Empty space, R = Rock, P = Player start, M = Monster, D = Dragon
........................................
........................................
........................................
WWWWWWWWWWWWWWWWWPWWWWWWWWWWWWWWWWWWWWWW
WWWWWWWWWWWWWWWWW.WWWWWWWWWWWWWWWWWWWWWW
WWWWWWWWWWWWWWWWW.WWWWWWWWWWWWWWWWWWWWWW
WWWWWWWWWWWWRWWWW.WWWWWRWWWWWWWRWWWWWWWW
WWWWWWWWWWWWWWWWW.WWWWWWWWWWWWWWWWWWWWWW
WWWWWWWWWWWWWWWWW.WWWWWWWWWWWWWWWWWWWWWW
WWWWWWWWWRWWWWWWW.WWWWWWWRWWWWWWWWWWWWWW
WWWWWWWWWWWWWWWWW.WWWWWWWWWWWWWWWWWWWWWW
WWWWWWWWWWWWWWWWW.WWWWWWWWWWWWWWWWWWWWWW
WWW....RWWWWWWWWW.WWWWWWWWWWWR....RWWWWW
WWW.MM.RWWWWWWWWW.WWWWWWWWWWWR.DD.RWWWWW
WWW....RWWWWWWWWW.WWWWWWWWWWWR....RWWWWW
WWWWWWWWWWWWWWWWW.WWWWWWWWWWWWWWWWWWWWWW
WWWWWWWWWWWWRWWWW.WWWWWRWWWWWWWWWWWWWWWW
WWWWWWWWWWWWWWWWW.WWWWWWWWWWWWWWWWWWWWWW
WWWWWWWWWWWWWWWWW.WWWWWWWWWWWWWWWWWWWWWW
WWWWWWWWWWWWWWWWW.WWWWWWWWWWWWWWWWWWWWWW
WWWWWWWWWWWWWWWWW.WWWWWWWWWWWWWWWWWWWWWW
WWWWWWWWWWWWRWWWW.WWWWWRWWWWWWWWWWWWWWWW
WWW....RWWWWWWWWW.WWWWWWWWWWWR....RWWWWW
WWW.MD.RWWWWWWWWW.WWWWWWWWWWWR.DM.RWWWWW
WWW....RWWWWWWWWW.WWWWWWWWWWWR....RWWWWW
WWWWWWWWWWWWWWWWW.WWWWWWWWWWWWWWWWWWWWWW
WWWWWWWWWWWWWWWWWWWWWWWWWWWWWWWWWWWWWWWW
WWWWWWWWWWWWWWWWWWWWWWWWWWWWWWWWWWWWWWWW
WWWWWWWWWWWWWWWWWWWWWWWWWWWWWWWWWWWWWWWW
WWWWWWWWWWWWWWWWWWWWWWWWWWWWWWWWWWWWWWWW
WWWWWWWWWWWWWWWWWWWWWWWWWWWWWWWWWWWWWWWW
WWWWWWWWWWWWWWWWWWWWWWWWWWWWWWWWWWWWWWWW
