# Level 4: Rock Maze - Scattered rocks create complex terrain
# W = Wall/Earth, . = Empty space, R = Rock, P = Player start, M = Monster, D = Dragon
........................................
........................................
........................................
WWWWWWWWWWWWWWWWWPWWWWWWWWWWWWWWWWWWWWWW
WWWWWWWWWWWWWWWWW.WWWWWWWWWWWWWWWWWWWWWW
WWWWWWWWWWWWWWWWW.WWWWWWWWWWWWWWWWWWWWWW
WWWWWWWWWWWWRWWWR.RWWWRWWWWWWWWWWWWWWWWW
WWWWWWWWWWWWWWWWW.WWWWWWWWWWWWWWWWWWWWWW
WWWWWWWWWWWWWWWWR.RWWWWWWWWWWWWWWWWWWWWW
WWWWWWWWWWWWWWWWW.WWWWWWWWWWWWWWWWWWWWWW
WWWWWWWWWWWWWWWWR.RWWWWWWWWWWWWWWWWWWWWW
WWWWWWWWWWWWWWWWW.WWWWWWWWWWWWWWWWWWWWWW
WWWWWWWWWWWWRWWWR.RWWWRWWWWWWWWWWWWWWWWW
WWWWWWWWWWWWWWWWW.WWWWWWWWWWWWWWWWWWWWWW
WWWWWWWWWWWWWWWWR.RWWWWWWWWWWWWWWWWWWWWW
WWWWWWWWWWWWWWWWW.WWWWWWWWWWWWWWWWWWWWWW
WWWWWWWWR........M.......DRWWWWWWWWWWWWW
WWWWWWWWR.WWWWWWWWWWWWWWWW.RWWWWWWWWWWWW
WWWWWWWWR.WWWWWWWWWWWWWWWW.RWWWWWWWWWWWW
WWWWWWWWR.WWWWWWWWWWWWWWWW.RWWWWWWWWWWWW
WWWWWWWWR.WWWWWWWWWWWWWWWW.RWWWWWWWWWWWW
WWWWWWWWR.WWWWWWWWWWWWWWWW.RWWWWWWWWWWWW
WWWWWWWWR.WWWWWWWWWWWWWWWW.RWWWWWWWWWWWW
WWWWWWWWR.WWWWWWWWWWWWWWWW.RWWWWWWWWWWWW
WWWWWWWWR.WWWWWWWWWWWWWWWW.RWWWWWWWWWWWW
WWWWWWWWR........M.......D.RWWWWWWWWWWWW
WWWWWWWWWWWWWWWWWWWWWWWWWWWWWWWWWWWWWWWW
WWWWWWWWWWWWWWWWWWWWWWWWWWWWWWWWWWWWWWWW
WWWWWWWWWWWWWWWWWWWWWWWWWWWWWWWWWWWWWWWW
WWWWWWWWWWWWWWWWWWWWWWWWWWWWWWWWWWWWWWWW
WWWWWWWWWWWWWWWWWWWWWWWWWWWWWWWWWWWWWWWW
WWWWWWWWWWWWWWWWWWWWWWWWWWWWWWWWWWWWWWWW
